W W W W W W W W W W
W S . . . W . . A W
W . W W . W . W . W
W . W . . . . W . W
W . W . W W . W . W
W . . . W . . . . W
W W W . W W W W . W
W . . . . . . W . W
W A W W W W . . . W
W W W W W W W W W W