. . . . . . . . . .
. A . . P . . . A .
. . . . . . . . . .
. . W . . S . . W .
. Q . . . . . . P .
. . . . . . . . . .
. W . . A . . . W .
. . . . . . . . . .
. A . . Q . . . A .
. . . . . . . . . .