. . . . . . . . . .
. . S . . . . . . .
. . . . A . . . . .
. A . . . . A . . .
. . . W . . W . . .
. . . . . . . . . .
. . W . . . W . . .
. . . . A . . . . .
. . . . . . . . . .
. . . . . . . . . .