. . W W W W W W . .
. . . . . . A . . .
W . P . W W . . . W
W . . . W . . Q . W
. . S . . . . . . .
W . . . W . . . . W
W . Q . W . P . . W
W . . . W . . . . W
. . . . . . . . A .
. A W W . . W W . .