. . . . . . . . . .
. . A . . W . . A .
. W . W . . W . . .
. . . . W . . W . .
. . W . . S . . W .
. . . . W . . . . .
. W . . . . . W . .
. . W . W . W . . .
. . . . . W . . A .
. . . . . . . . . .